MMMMMMMMMMMMMMMMMMMMMMMMMMMMMMMMMMMMMMMM
MGGGGGGGGGGGGGGGGGGGGGGGGGGGGGGGGGGGGGGM
MGRGGGGGGGRGGGGGRGGGRGGGGGGGGGRGGGGGRGGM
MGGGGGGGGGGGGGGGGGGGGGGGGGGGGGGGGGGGGGGM
MGGGGGGGGGGGGGGGGGGGGGGGGGGGGGGGGGGGGGGM
MGGGGGWWGGGGGGGGGGGGGGGGWWGGGGGGGGGGGGGM
MGRGGWWWWGGGRGGRGGGGRGGWWWWGGGGGRGGRGGGM
MGGGGWWWWGGGGGGGGGGGGGGWWWWGGGGGGGGGGGGM
MGGGGGWWGGGGGGGGRGGGGGGGWWGGGGGGGGGGRGGM
MGGGGGGGGGGGGGGGGGGGGGGGGGGGGGGGGGGGGGGM
MGGGGGGGGGRGGGGGGGGGGGGGGGGGRGGGGGGGGGGM
MGGRGGGGGGGGGGGGGGGGGRGGGGGGGGGGGGGGGGGM
MGGGGGGGGGWWWGGGGGGGGGGGGGGGWWWGGGGGGGGM
MGGGGRGGGWWWWWGGGGGGGGGRGGGWWWWWGGGGGGGM
MGGGGGGGGWWWWWGGGGGGGGGGGGGWWWWWGGGGGGGM
MGGGGGGGGGWWWGGGGGGGGGGGGGGGWWWGGGGGGGGM
MGGGGRGGGGGGGGGGGRGGGGGRGGGGGGGGGGGRGGGM
MGGGGGGGGGGGGGRGGGGGGGGGGGGGGGGGRGGGGGGM
MGGGGGGGGGGGGGGGGGGGGGGGGGGGGGGGGGGGGGGM
MMMMMMMMMMMMMMMMMMMMMMMMMMMMMMMMMMMMMMMM
